oooooo----oooooo
ooooo------ooooo
oooo--------oooo
ooo----++----ooo
oo----++++----oo
oo---++++++---oo
##---++++++---##
##----++++----##
###----++----###
####--------####
#####------#####
######----######